111111111
0PCE00000
000000000
111111111