11111111111
10000000001
10000000001
10P00000001
11111111111