1111111111111
1111100001
111000001111
1000000001
10000PCE1
1111111111111