11111111111111111111
1P0000000000000000C1
10000000000000000001
1000000000000000CCC1
1000000000000000CCC1
10000001111100000001
10000000000000000001
10000000000000000111
1CCCC000000000000101
11111000000111100101
10000000000111100101
11111111000000000001
1CCCCCC0000000000001
10000000000000000001
10000000000000000001
11000000000000000001
100CCCCCC00000000001
1C111000000CCCC00001
100000000000000000E1
11111111111111111111