11111111
100C0001
10011101
10E001C1
1C0P0C01
11111111