111111
100C01
100111
10E001
1C0P01
111111